advancements - 발전과제에 달성, 철회등을 조절한다.
ban - 어떤 플레이어의 접속을 불가하게 만든다.
op - 지정된 플레이어의 명령어권한을 부여한다.
deop - 지정된 플레이어의 명령어권한을 취소한다.
pardon - 접속불가된 권한을 취소시킨다.
ban-ip - 지정된 ip를 가진 플레이어의 접속권한을 없앤다.
clear - 지정된 플레이어의 아이템을 없앤다.
clone - 2개의 지정된 좌표안에 있는 건축물을 3번째 좌표에 붙여넣는다.
defficulty - 이 월드의 난이도를 조절한다.
effect - 지정된 엔티티에 효과를 부여한다.
enchant - 지정된 엔티티가 들고 있는 아이템에 마법을 부여한다.
give - 지정된 엔티티에게 아이템을 지급한다.
replaceitem - 지정된 엔티티에 슬롯에 아이템을 바꾼다.
fill - 좌표2개의 안에 있는 블럭을 설정된 블럭으로 바꾼다.
gamemode - 플레이어의 게임모드를 설정한다.
kick - 지정 플레이어를 접속을 종료시킨다.
tell - 지정 플레이어에게 메시지를 보낸다.
tellraw - 지정플레이어에게 여러 효과가있는 메시지를 보낸다.
playsound - 지정 플레이어에게 마인크래프트 소리를 플레이시킨다.
stopsound - 지정 플레이어에게 재생되고 있는 소리를 정지시킨다.
say - 모든 플레이어에게 메시지를 보낸다.
setblock - 지정된 좌표에 블럭을 설정한다.
setworldspawn - 월드의 시작지점을 설정한다.
stop - 서버를 끈다.
summon - 지정된 엔티티를 생성시킨다.
time - 시간을 설정한다.
title - 지정된 플레이어의 화면에 큰 글씨를 띄운다.
trigger - 지정된 트리거스코어보드에 점수를 부여한다.
whitelist - 화이트리스트가 켜져있을때는 화이트리스트 안에 있는사람만 접속이 가능하다.
worldborder - 월드보더를 설정한다.
pardon-ip - 지정된 접속거부된 ip의 밴을 푼다.
tp - 지정된 엔티티를 어떤 위치로 순간이동시킨다.
spawnpoint - 지정된 플레이어의 생성지점을 설정한다.
kill - 지정엔티티를 없앤다.
spreadplayers - 지정엔티티를 지정된 중앙좌표를 기준으로 산개시킨다.
scoreboard - 점수판을 다루는 명령어이다.
particle - 입자를 생성시킨다.
